10
##########
#S.####..#
#@P####.J#
#B.##S#..#
#G..O.#..#
#......#.#
####..L.B#
####.#####
##KT.#####
##########